NO ./asset/no.xpm
SO ./asset/so.xpm
WE ./asset/we.xpm
EA ./asset/ea.xpm

F 255,255,255
C 0,0,0

111

11      1111111111111111111111111
        1000000000110000000000001
        1011000001110000000000001
        1001000000000000000000001
111111111011000001110000000000001
100000000011000001110111111111111
11110000000000000100000010001
11110000000000000001010000001
11000000000000000W10000000001
10000000000000000000000000001
1000000000000000000101000000111111111111
1100000111010101111101111000000000000001
11110111 1110101 10111101000111111111111
11111111 1111111 111111111111
